ooXXXXXXXXXXXX
oooooooooooBXX
XonoXXXXoXXXXX
XoBXXXXooooXXX
XXXXBoooXXooXX
XXXXXXXXXXooXX
XBoooXXooooXXX
XXoXoXnoXXooXX
XooooooooXXoBX
XXXXXXXooXXXXX
XXXXXXXoXXooXX
FooooooonooBoX
XXXoXXXoooXXoX
XXXXXXXXXXXXXX